size : 21, 21
tileset : main_tile_set
[Layout1]
107 107 107 107 107 107 107 107 107 107 107 107 107 107 107 107 107 107 107 107 107
107 107 107 107 107 107 107 107 107 107 107 107 107 107 107 107 107 107 107 107 107
107 107 107 107 107 107 107 107 107 107 107 107 107 107 107 107 107 107 107 107 107
107 107 107 107 107 107 107 107 107 107 107 107 107 107 107 107 107 107 107 107 107
107 107 107 107 107 107 107 107 107 107 107 107 107 107 107 107 107 107 107 107 107
107 107 107 107 107 107 107 107 107 107 107 107 107 107 107 107 107 107 107 107 107
107 107 107 107 107 107 107 107 107 107 107 107 107 107 107 107 107 107 107 107 107
107 107 107 107 107 107 169 169 169 169 169 169 169 107 107 107 107 107 107 107 107
107 107 107 107 107 107 169 169 169 169 169 169 169 107 107 107 107 107 107 107 107
107 107 107 107 107 107 169 169 169 169 169 169 169 107 107 107 107 107 107 107 107
107 107 107 107 107 107 169 169 169 169 169 169 169 107 107 107 107 107 107 107 107
107 107 107 107 107 107 169 169 169 169 169 169 169 107 107 107 107 107 107 107 107
107 107 107 107 107 107 169 169 169 169 169 169 169 107 107 107 107 107 107 107 107
107 107 107 107 107 107 169 169 169 169 169 169 169 107 107 107 107 107 107 107 107
107 107 107 107 107 107 169 169 169 169 169 169 169 107 107 107 107 107 107 107 107
107 107 107 107 107 107 169 169 169 169 169 169 169 107 107 107 107 107 107 107 107
107 107 107 107 107 107 107 107 107 107 107 107 107 107 107 107 107 107 107 107 107
107 107 107 107 107 107 107 107 107 107 107 107 107 107 107 107 107 107 107 107 107
107 107 107 107 107 107 107 107 107 107 107 107 107 107 107 107 107 107 107 107 107
107 107 107 107 107 107 107 107 107 107 107 107 107 107 107 107 107 107 107 107 107
107 107 107 107 107 107 107 107 107 107 107 107 107 107 107 107 107 107 107 107 107
[/Layout1]
[Layout2]
0 0 0 0 0 0 0 0 0 0 0 0 0 0 0 0 0 0 0 0 0
0 0 0 0 0 0 0 0 0 0 0 0 0 0 0 0 0 0 0 0 0
0 0 0 0 0 0 0 0 0 0 0 0 0 0 0 0 0 0 0 0 0
0 0 0 0 0 0 0 0 0 0 0 0 0 0 0 0 0 0 0 0 0
0 0 0 0 0 0 0 0 0 0 0 0 0 0 0 0 0 0 0 0 0
0 0 0 0 0 0 0 0 0 0 0 0 0 0 0 0 0 0 0 0 0
0 0 0 0 0 0 0 0 0 0 0 0 0 0 0 0 0 0 0 0 0
0 0 0 0 0 0 0 0 0 0 0 0 0 0 0 0 0 0 0 0 0
0 0 0 0 0 0 0 0 0 0 0 0 0 0 0 0 0 0 0 0 0
0 0 0 0 0 0 0 0 0 0 0 0 0 0 0 0 0 0 0 0 0
0 0 0 0 0 0 0 0 0 0 0 0 0 0 0 0 0 0 0 0 0
0 0 0 0 0 0 0 0 0 0 0 0 0 0 0 0 0 0 0 0 0
0 0 0 0 0 0 0 0 0 0 0 0 0 0 0 0 0 0 0 0 0
0 0 0 0 0 0 0 0 0 0 0 0 0 0 0 0 0 0 0 0 0
0 0 0 0 0 0 0 0 0 0 0 0 0 0 0 0 0 0 0 0 0
0 0 0 0 0 0 0 0 0 0 0 0 0 0 0 0 0 0 0 0 0
0 0 0 0 0 0 0 0 0 0 0 0 0 0 0 0 0 0 0 0 0
0 0 0 0 0 0 0 0 0 0 0 0 0 0 0 0 0 0 0 0 0
0 0 0 0 0 0 0 0 0 0 0 0 0 0 0 0 0 0 0 0 0
0 0 0 0 0 0 0 0 0 0 0 0 0 0 0 0 0 0 0 0 0
0 0 0 0 0 0 0 0 0 0 0 0 0 0 0 0 0 0 0 0 0
[/Layout2]
[Layout3]
0 0 0 0 0 0 0 0 0 0 0 0 0 0 0 0 0 0 0 0 0
0 0 0 0 0 0 0 0 0 0 0 0 0 0 0 0 0 0 0 0 0
0 0 0 0 0 0 0 0 0 0 0 0 0 0 0 0 0 0 0 0 0
0 0 0 0 0 0 0 0 0 0 0 0 0 0 0 0 0 0 0 0 0
0 0 0 0 0 0 0 0 0 0 0 0 0 0 0 0 0 0 0 0 0
0 0 0 0 0 0 0 0 0 0 0 0 0 0 0 0 0 0 0 0 0
0 0 0 0 0 0 0 0 0 0 0 0 0 0 0 0 0 0 0 0 0
0 0 0 0 0 0 0 0 0 0 0 0 0 0 0 0 0 0 0 0 0
0 0 0 0 0 0 0 0 0 0 0 0 0 0 0 0 0 0 0 0 0
0 0 0 0 0 0 0 0 0 0 0 0 0 0 0 0 0 0 0 0 0
0 0 0 0 0 0 0 0 0 0 0 0 0 0 0 0 0 0 0 0 0
0 0 0 0 0 0 0 0 0 0 0 0 0 0 0 0 0 0 0 0 0
0 0 0 0 0 0 0 0 0 0 0 0 0 0 0 0 0 0 0 0 0
0 0 0 0 0 0 0 0 0 0 0 0 0 0 0 0 0 0 0 0 0
0 0 0 0 0 0 0 0 0 0 0 0 0 0 0 0 0 0 0 0 0
0 0 0 0 0 0 0 0 0 0 0 0 0 0 0 0 0 0 0 0 0
0 0 0 0 0 0 0 0 0 0 0 0 0 0 0 0 0 0 0 0 0
0 0 0 0 0 0 0 0 0 0 0 0 0 0 0 0 0 0 0 0 0
0 0 0 0 0 0 0 0 0 0 0 0 0 0 0 0 0 0 0 0 0
0 0 0 0 0 0 0 0 0 0 0 0 0 0 0 0 0 0 0 0 0
0 0 0 0 0 0 0 0 0 0 0 0 0 0 0 0 0 0 0 0 0
[/Layout3]
